1111111111111
10000000000E1
1010101111001
10101000010C1
1011100111001
1000101000001
1000101111001
10000000000P1
1111111111111