1111111111111
10100000000E1
1010101111001
10101000010C1
11111C1111111
1000101000001
1000101111001
10000000000P1
1111111111111